11x...xx...x22
11x.x....x.x22
11x........x22
11...x..x...22
11x........x22
11x.x....x.x22
11x...xx...x22
