1 1 1 1 1
. x 1 x .
. . x . .
. x 2 x .
2 2 2 2 2
